{
  "levels": [
    {
      "name": "Level 1",
      "data": [
        [30, 24, 25, 25, 26, 27, 28, 29, 30, 28],
        [24, 23, 23, 23, 23, 23, 23, 23, 23, 24],
        [25, 22, 11, 4, 15, 9, 17, 2, 22, 24],
        [26, 22, 6, 18, 0, 14, 3, 16, 22, 28],
        [27, 22, 10, 7, 19, 1, 13, 5, 22, 29],
        [28, 22, 2, 16, 11, 8, 20, 4, 22, 25],
        [29, 22, 15, 3, 9, 17, 6, 12, 22, 27],
        [30, 22, 0, 21, 14, 5, 18, 10, 22, 26],
        [24, 23, 23, 23, 23, 23, 23, 23, 22, 24],
        [24, 24, 25, 25, 26, 27, 28, 29, 30, 26]
      ]
    },
    {
      "name": "Level 2",
      "data": [
        [30, 24, 25, 26, 27, 28, 29, 30, 31, 24, 25, 26],
        [24, 23, 23, 23, 23, 23, 23, 23, 23, 23, 23, 24],
        [25, 22, 16, 5, 12, 1, 10, 8, 14, 3, 22, 24],
        [26, 22, 9, 14, 2, 17, 4, 11, 0, 15, 22, 28],
        [27, 22, 3, 11, 7, 19, 15, 6, 18, 1, 22, 29],
        [28, 22, 17, 0, 13, 5, 8, 12, 2, 10, 22, 25],
        [29, 22, 4, 18, 6, 10, 1, 16, 11, 7, 22, 27],
        [30, 22, 15, 9, 3, 12, 20, 14, 5, 13, 22, 26],
        [24, 23, 23, 23, 23, 23, 23, 23, 23, 23, 22, 24],
        [24, 24, 25, 26, 27, 28, 29, 30, 31, 24, 25, 26]
      ]
    },
    {
      "name": "Level 3",
      "data": [
        [30, 24, 25, 26, 27, 28, 29, 30, 31, 24, 25, 26, 27, 28],
        [24, 23, 23, 23, 23, 23, 23, 23, 23, 23, 23, 23, 23, 24],
        [25, 22, 9, 14, 5, 18, 2, 16, 7, 11, 0, 19, 22, 24],
        [26, 22, 17, 3, 10, 6, 21, 1, 15, 8, 12, 4, 22, 28],
        [27, 22, 1, 12, 4, 15, 9, 5, 18, 0, 13, 16, 22, 29],
        [28, 22, 13, 7, 19, 2, 11, 14, 3, 10, 20, 6, 22, 25],
        [29, 22, 5, 16, 0, 13, 8, 4, 12, 7, 15, 18, 22, 27],
        [30, 22, 11, 2, 20, 9, 17, 6, 1, 14, 3, 10, 22, 26],
        [24, 23, 23, 23, 23, 23, 23, 23, 23, 23, 23, 23, 22, 24],
        [24, 24, 25, 26, 27, 28, 29, 30, 31, 24, 25, 26, 27, 28]
      ]
    },
    {
      "name": "Level 4",
      "data": [
        [30, 24, 25, 26, 27, 28, 29, 30, 31, 24, 25, 26, 27, 28, 24, 24],
        [24, 23, 23, 23, 23, 23, 23, 23, 23, 23, 23, 23, 23, 23, 23, 24],
        [25, 22, 17, 3, 11, 6, 14, 1, 19, 8, 4, 12, 16, 5, 22, 24],
        [26, 22, 9, 15, 2, 13, 7, 20, 0, 10, 18, 5, 14, 3, 22, 28],
        [27, 22, 1, 10, 16, 4, 8, 12, 3, 17, 6, 11, 0, 19, 22, 29],
        [28, 22, 13, 7, 19, 5, 0, 15, 2, 14, 9, 18, 1, 16, 22, 25],
        [29, 22, 5, 18, 14, 1, 10, 6, 17, 11, 3, 20, 4, 8, 22, 27],
        [30, 22, 11, 2, 20, 9, 16, 3, 15, 7, 13, 4, 19, 12, 22, 26],
        [24, 23, 23, 23, 23, 23, 23, 23, 23, 23, 23, 23, 23, 23, 22, 24],
        [24, 24, 25, 26, 27, 28, 29, 30, 31, 24, 25, 26, 27, 28, 24, 24]
      ]
    },
    {
      "name": "Level 5",
      "data": [
        [30, 24, 25, 26, 27, 28, 29, 30, 31, 24, 25, 26, 27, 28, 24, 24, 30],
        [24, 23, 23, 23, 23, 23, 23, 23, 23, 23, 23, 23, 23, 23, 23, 23, 24],
        [25, 22, 12, 5, 18, 3, 11, 7, 14, 2, 16, 9, 20, 1, 15, 22, 24],
        [26, 22, 7, 16, 4, 13, 9, 15, 6, 0, 17, 10, 8, 19, 3, 22, 28],
        [27, 22, 1, 19, 10, 5, 17, 2, 11, 14, 3, 12, 6, 8, 20, 22, 29],
        [28, 22, 15, 4, 13, 0, 18, 7, 3, 16, 9, 14, 1, 11, 5, 22, 25],
        [29, 22, 8, 17, 6, 11, 1, 19, 5, 13, 20, 4, 10, 12, 7, 22, 27],
        [30, 22, 16, 3, 12, 14, 0, 8, 10, 6, 15, 18, 7, 2, 4, 22, 26],
        [24, 23, 23, 23, 23, 23, 23, 23, 23, 23, 23, 23, 23, 23, 23, 22, 24],
        [24, 24, 25, 26, 27, 28, 29, 30, 31, 24, 25, 26, 27, 28, 24, 24, 26]
      ]
    }
  ]
}
