{
  "levels": [
    {
      "name": "Level 1",
      "rows": 10,
      "columns": 10,
      "data": [
        30,24,25,25,26,27,28,29,30,28,
        24,0,23,23,23,23,23,23,0,24,
        25,22,9,0,34,0,0,18,22,24,
        26,22,0,34,0,0,33,0,22,28,
        27,22,15,0,0,32,0,0,22,29,
        28,22,0,0,12,0,0,12,22,25,
        29,22,0,0,0,15,0,0,22,27,
        30,22,0,34,0,0,0,9,22,26,
        24,0,23,23,23,23,23,23,0,24,
        24,24,25,25,26,27,28,29,30,26
      ]
    },
    {
      "name": "Level 2",
      "rows": 12,
      "columns": 12,
      "data": [
        30,24,25,25,26,27,28,29,30,31,24,25,
        24,23,23,23,23,23,23,23,23,23,23,24,
        25,22,0,0,0,20,0,0,0,0,22,24,
        26,22,0,0,0,0,10,0,0,0,22,28,
        27,22,5,0,0,0,0,0,0,0,22,29,
        28,22,16,16,16,16,16,16,16,16,22,25,
        29,22,3,0,0,0,0,0,20,0,22,27,
        30,22,0,0,11,0,0,0,4,5,22,26,
        31,22,0,0,0,0,0,0,2,3,22,24,
        30,22,0,11,0,20,0,0,0,0,22,28,
        24,23,23,23,23,23,23,23,23,23,23,24,
        24,24,25,25,26,27,28,29,30,31,24,26
      ]
    },
    {
      "name": "Level 3",
      "rows": 14,
      "columns": 14,
      "data": [
        30,24,25,25,26,27,28,29,30,31,24,25,26,27,
        24,9,23,23,23,23,23,23,23,23,23,23,9,24,
        25,22,15,0,0,0,0,0,0,0,0,0,22,24,
        26,22,0,34,0,0,0,12,0,0,9,33,22,28,
        27,22,0,0,0,0,20,0,0,15,0,0,22,29,
        28,22,0,11,0,0,0,0,0,10,0,0,22,25,
        29,22,0,0,0,0,0,32,0,0,0,0,22,27,
        30,22,0,0,19,0,0,0,0,6,0,0,22,26,
        31,22,12,0,0,0,0,17,0,0,0,9,22,24,
        30,22,0,0,0,0,0,0,0,1,0,15,22,28,
        28,22,0,0,10,0,0,0,0,0,0,0,22,30,
        24,22,20,0,0,0,13,0,0,7,0,0,22,31,
        24,9,23,23,23,23,23,23,23,23,23,23,9,24,
        24,24,25,25,26,27,28,29,30,31,24,25,26,26
      ]
    },
    {
      "name": "Level 4",
      "rows": 16,
      "columns": 16,
      "data": [
        30,24,25,25,26,27,28,29,30,31,24,25,26,27,28,24,
        24,9,23,23,23,23,23,23,23,23,23,23,23,23,9,24,
        25,22,14,0,0,0,11,0,0,0,11,0,0,12,22,24,
        26,22,1,0,0,0,0,0,0,0,0,0,0,14,22,28,
        27,22,1,0,0,20,0,0,32,0,0,33,0,0,22,29,
        28,22,1,0,20,0,0,34,0,0,0,34,0,0,22,25,
        29,22,0,6,0,0,0,0,6,0,0,0,6,0,22,27,
        30,22,0,16,0,16,0,16,0,16,0,16,0,16,22,26,
        31,22,16,0,16,0,16,0,16,0,16,0,16,0,22,24,
        30,22,0,0,0,0,0,0,0,0,0,0,0,0,22,28,
        28,22,0,0,0,10,0,0,0,10,0,0,11,0,22,30,
        24,22,12,0,0,0,19,0,0,0,13,0,0,0,22,31,
        26,22,0,0,0,0,20,0,0,0,33,0,0,34,22,30,
        27,22,0,0,7,0,0,8,0,0,13,0,0,18,22,29,
        24,9,23,23,23,23,23,23,23,23,23,23,23,23,9,24,
        24,24,25,25,26,27,28,29,30,31,24,25,26,27,28,24
      ]
    },
    {
      "name": "Level 5",
      "rows": 17,
      "columns": 17,
      "data": [
        30,24,25,25,26,27,28,29,30,31,24,25,26,27,28,24,24,
        24,15,23,23,23,23,23,23,9,23,23,23,23,23,23,15,24,
        25,22,14,0,0,20,0,0,22,0,0,0,0,33,14,22,24,
        26,22,0,0,32,0,0,0,22,0,17,0,0,0,17,22,28,
        27,22,0,17,0,0,0,0,22,0,0,8,8,0,0,22,29,
        28,22,0,0,7,7,0,0,22,0,0,32,0,0,0,22,25,
        29,22,12,0,0,0,33,0,22,0,0,0,33,0,0,22,27,
        30,22,0,34,0,0,0,0,22,0,0,0,0,34,0,22,26,
        30,9,23,23,23,23,23,23,6,23,23,23,23,23,23,9,28,
        31,22,0,0,0,32,0,0,22,0,0,0,32,0,0,22,24,
        28,22,0,0,11,0,0,11,22,0,34,0,0,11,0,22,30,
        24,22,12,0,0,0,0,0,22,10,0,0,0,0,33,22,31,
        26,22,0,0,18,0,0,0,22,0,0,13,0,0,0,22,30,
        27,22,0,0,32,0,0,0,22,0,33,0,0,0,13,22,29,
        25,22,12,0,34,0,0,33,22,0,0,0,34,0,17,22,28,
        24,15,23,23,23,23,23,23,9,23,23,23,23,23,23,15,24,
        24,24,25,25,26,27,28,29,30,31,24,25,26,27,28,24,26
      ]
    },

    {
      "name": "Level 6",
      "rows": 18,
      "columns": 18,
      "data": [
        30,24,25,25,26,27,28,29,30,31,24,25,26,27,28,24,24,30,
        24,9,23,23,23,23,23,23,9,23,23,23,23,23,23,23,9,24,
        25,22,14,0,0,20,0,0,22,0,0,0,0,0,33,14,22,24,
        26,22,0,0,32,0,0,0,22,0,17,0,0,0,0,17,22,28,
        27,22,0,17,0,0,0,0,22,0,0,8,8,0,0,0,22,29,
        28,22,0,0,7,7,0,0,22,0,0,32,0,0,0,19,22,25,
        29,22,12,0,0,0,33,0,22,5,0,0,33,0,0,0,22,27,
        30,22,0,34,0,0,0,0,22,3,0,0,0,34,0,19,22,26,
        30,9,23,23,23,23,23,23,6,23,23,23,23,23,23,23,9,28,
        31,22,0,0,0,32,0,0,22,0,0,0,32,0,0,0,22,24,
        28,22,0,0,11,0,0,11,22,0,34,0,0,11,0,0,22,30,
        24,22,12,0,0,0,0,0,22,10,0,0,0,0,0,33,22,31,
        26,22,0,0,18,0,0,13,22,0,0,13,0,0,0,0,22,30,
        27,22,0,0,32,0,0,0,22,0,33,0,0,0,0,13,22,29,
        25,22,12,0,34,0,0,33,22,4,5,0,34,0,0,17,22,28,
        29,22,0,0,0,0,0,13,22,2,3,0,0,0,0,0,22,27,
        24,9,23,23,23,23,23,23,9,23,23,23,23,23,23,23,9,24,
        24,24,25,25,26,27,28,29,30,31,24,25,26,27,28,24,24,30
      ]
    },

    {
      "name": "Level 7",
      "rows": 20,
      "columns": 20,
      "data": [
        30,24,25,25,26,27,28,29,30,31,24,25,26,27,28,24,24,30,31,28,
        24,9,23,23,23,23,23,23,23,23,23,23,23,23,23,23,23,23,9,24,
        25,22,14,0,0,20,0,0,0,22,0,0,0,0,0,0,33,14,22,24,
        26,22,0,0,32,0,0,0,0,22,17,0,0,0,0,0,0,17,22,28,
        27,22,0,17,0,0,7,0,0,22,8,0,0,0,0,19,0,0,22,29,
        28,22,0,0,7,0,0,0,0,22,32,0,0,0,8,0,0,19,22,25,
        29,22,12,0,0,0,33,0,0,22,0,0,33,0,0,0,0,0,22,27,
        30,22,0,34,0,0,0,0,0,22,0,0,0,34,0,0,0,19,22,26,
        31,22,0,0,0,32,0,0,0,22,0,0,32,0,0,8,0,0,22,24,
        30,9,23,23,23,23,23,23,23,6,23,23,23,23,23,23,23,23,9,28,
        28,22,0,0,11,0,0,0,11,22,34,0,0,11,0,0,0,0,22,30,
        24,22,12,0,0,0,0,0,0,22,0,0,16,0,0,0,0,33,22,31,
        26,22,0,0,18,0,0,0,13,22,13,0,0,0,0,0,0,0,22,30,
        27,22,0,0,0,32,0,0,0,22,33,0,0,0,16,0,0,13,22,29,
        25,22,12,0,0,34,0,33,0,22,0,0,34,0,0,0,0,17,22,28,
        29,22,0,0,0,0,0,0,13,22,0,0,0,4,5,0,0,0,22,27,
        31,22,0,0,0,15,0,0,0,22,0,0,0,2,3,0,0,0,22,24,
        24,22,0,32,0,0,0,34,0,22,0,0,0,0,0,0,0,12,22,25,
        24,9,23,23,23,23,23,23,23,23,23,23,23,23,23,23,23,23,9,24,
        24,24,25,25,26,27,28,29,30,31,24,25,26,27,28,24,24,30,31,26
      ]
    },

    {
      "name": "Level 8",
      "rows": 20,
      "columns": 20,
      "data": [
        30,24,25,25,26,27,28,29,30,31,24,25,26,27,28,24,24,30,31,28,
        24,23,23,23,23,23,23,23,23,23,23,23,23,23,23,23,23,23,23,24,
        25,22,6,0,0,0,0,0,10,22,0,0,0,13,0,0,6,12,22,24,
        26,22,0,6,0,0,4,5,0,22,8,0,0,0,0,6,0,0,22,28,
        27,22,0,0,6,0,2,3,0,22,0,0,17,0,6,0,0,0,22,29,
        28,22,0,0,0,6,0,0,0,22,10,0,0,6,0,0,0,11,22,25,
        29,22,0,17,0,0,6,0,0,22,0,0,6,0,0,19,0,0,22,27,
        30,22,0,0,0,1,0,6,0,22,0,6,0,20,0,0,0,33,22,26,
        31,22,14,0,0,0,0,0,6,22,6,0,0,0,11,0,0,14,22,24,
        30,9,16,16,16,16,16,16,16,6,16,16,16,16,16,16,16,16,9,28,
        28,22,20,0,0,0,0,0,6,22,6,0,0,0,33,0,0,12,22,30,
        24,22,0,0,13,0,0,6,0,22,0,6,0,34,0,0,0,0,22,31,
        26,22,8,0,0,0,6,0,0,22,0,0,6,0,0,0,33,0,22,30,
        27,22,0,0,0,6,0,7,0,22,20,0,0,6,0,0,32,0,22,29,
        25,22,0,0,6,0,0,0,0,22,0,0,0,0,6,0,0,0,22,28,
        29,22,0,6,7,0,15,0,0,22,0,0,34,0,0,6,0,0,22,27,
        31,22,6,0,0,0,0,0,0,22,0,0,0,0,0,20,6,0,22,24,
        24,22,12,0,0,0,8,0,0,22,0,0,33,0,0,0,0,6,22,25,
        24,23,23,23,23,23,23,23,23,23,23,23,23,23,23,23,23,23,22,24,
        24,24,25,25,26,27,28,29,30,31,24,25,26,27,28,24,24,30,31,26
      ]
    },

    {
      "name": "Level 9",
      "rows": 20,
      "columns": 20,
      "data": [
        30,24,25,25,26,27,28,29,30,31,24,25,26,27,28,24,24,30,31,28,
        24,23,23,23,23,23,23,23,23,23,23,23,23,23,23,23,23,23,23,24,
        25,22,20,0,32,0,33,0,34,22,0,0,0,17,0,1,0,14,22,24,
        26,22,0,33,0,32,0,20,0,22,0,0,0,17,0,1,0,0,22,28,
        27,22,34,0,33,0,32,0,20,22,0,0,0,17,0,1,0,0,22,29,
        28,22,0,34,0,32,0,20,0,22,0,0,0,0,0,0,0,0,22,25,
        29,22,0,0,0,0,0,0,0,22,0,0,10,0,0,0,11,0,22,27,
        30,22,0,33,0,20,0,34,0,22,4,5,0,0,0,0,0,0,22,26,
        31,22,20,0,34,0,33,0,32,22,2,3,0,0,11,0,0,14,22,24,
        30,9,23,23,23,23,23,23,23,6,23,23,23,23,23,23,23,23,9,28,
        28,22,14,0,0,0,0,0,0,22,19,0,0,0,0,19,0,14,22,30,
        24,22,0,0,0,0,0,0,0,22,0,0,12,0,0,0,0,8,22,31,
        26,22,16,16,16,16,16,16,16,22,0,0,0,0,0,0,0,0,22,30,
        27,22,0,0,0,0,0,0,0,22,19,0,0,13,0,0,0,7,22,29,
        25,22,0,0,0,0,0,0,0,22,0,0,0,0,0,0,0,0,22,28,
        29,22,16,16,16,16,16,16,16,22,0,0,18,0,0,19,0,0,22,27,
        31,22,0,6,0,6,0,6,0,22,13,0,0,0,0,0,0,0,22,24,
        24,22,14,0,6,0,6,0,6,22,0,0,0,19,0,0,0,14,22,25,
        24,23,23,23,23,23,23,23,23,23,23,23,23,23,23,23,23,23,22,24,
        24,24,25,25,26,27,28,29,30,31,24,25,26,27,28,24,24,30,31,26
      ]
    },
    {
      "name": "Level 10",
      "rows": 21,
      "columns": 21,
      "data": [
        30,24,25,25,26,27,28,29,30,31,24,25,26,27,28,24,24,30,31,28,26,
        24,9,23,23,23,23,23,23,23,23,23,23,23,23,23,23,23,23,23,9,23,
        25,22,13,0,0,7,0,0,0,32,0,0,0,33,0,0,0,4,5,22,24,
        26,22,0,0,0,34,0,0,0,15,0,0,8,0,0,9,0,2,3,22,28,
        27,22,13,0,0,0,0,0,33,0,0,0,0,0,0,34,0,0,13,22,29,
        28,22,0,0,0,0,0,7,0,0,0,0,0,33,0,0,0,0,18,22,25,
        29,22,0,0,18,0,0,0,0,0,33,0,0,0,10,0,0,0,0,22,27,
        30,22,7,0,0,0,0,0,18,0,0,0,8,0,0,0,0,0,11,22,26,
        31,22,0,0,0,0,0,0,0,6,6,6,6,0,0,0,0,0,0,22,24,
        30,22,18,0,0,0,0,0,0,6,4,5,6,0,0,0,0,0,18,22,28,
        25,22,33,0,0,0,0,0,0,6,2,3,6,0,0,0,0,0,7,22,24,
        26,22,0,0,0,32,0,0,0,6,6,6,6,0,0,18,0,0,0,22,28,
        27,22,0,0,0,8,0,0,0,0,0,0,0,34,0,0,0,0,0,22,29,
        28,22,0,0,0,0,33,0,0,0,0,0,0,7,0,0,0,0,0,22,25,
        29,22,0,0,10,0,0,0,0,33,0,0,0,0,0,32,0,0,0,22,27,
        30,22,0,0,15,0,0,0,0,0,13,0,0,0,0,0,0,0,0,22,26,
        31,22,0,0,0,0,0,32,0,0,0,0,0,0,34,0,0,0,0,22,24,
        24,22,4,5,0,0,0,0,0,0,7,0,0,0,0,0,0,0,0,22,25,
        24,22,2,3,0,0,0,0,16,0,0,0,0,8,0,0,0,0,0,22,24,
        24,9,23,23,23,23,23,23,23,23,23,23,23,23,23,23,23,23,23,9,24,
        24,24,25,25,26,27,28,29,30,31,24,25,26,27,28,24,24,30,31,26,26
      ]
    }
  ]
}
