[
    {
  "name": "Level 1",
  "data": [
    [30, 24, 25, 25, 26, 27, 28, 29, 30, 28],
    [24, 23, 23, 23, 23, 23, 23, 23, 23, 24],
    [25, 22, 11, 4, 15, 9, 17, 2, 22, 24],
    [26, 22, 6, 18, 0, 14, 3, 16, 22, 28],
    [27, 22, 10, 7, 19, 1, 13, 5, 22, 29],
    [28, 22, 2, 16, 11, 8, 20, 4, 22, 25],
    [29, 22, 15, 3, 9, 17, 6, 12, 22, 27],
    [30, 22, 0, 21, 14, 5, 18, 10, 22, 26],
    [24, 23, 23, 23, 23, 23, 23, 23, 22, 24],
    [24, 24, 25, 25, 26, 27, 28, 29, 30, 26]
  ]
    },
    {
  "name": "Level 2",
  "data": [
  [30, 24, 25, 25, 26, 27, 28, 29, 30, 31, 24, 25],
  [24, 23, 23, 23, 23, 23, 23, 23, 23, 23, 23, 24],
  [25, 22, 16, 5, 12, 1, 10, 8, 14, 3, 22, 24],
  [26, 22, 9, 14, 2, 17, 4, 11, 0, 15, 22, 28],
  [27, 22, 3, 11, 7, 19, 15, 6, 18, 1, 22, 29],
  [28, 22, 17, 0, 13, 5, 8, 12, 2, 10, 22, 25],
  [29, 22, 4, 18, 6, 10, 1, 16, 11, 7, 22, 27],
  [30, 22, 15, 9, 3, 12, 20, 14, 5, 13, 22, 26],
  [31, 22, 0, 16, 17, 7, 2, 15, 4, 18, 22, 24],
  [30, 23, 23, 23, 23, 23, 23, 23, 23, 23, 23, 28],
  [24, 23, 23, 23, 23, 23, 23, 23, 23, 23, 22, 24],
  [24, 24, 25, 25, 26, 27, 28, 29, 30, 31, 24, 26]
        ]
    },
     {
  "name": "Level 3",
  "data": [
  [30, 24, 25, 25, 26, 27, 28, 29, 30, 31, 24, 25, 26, 27],
  [24, 23, 23, 23, 23, 23, 23, 23, 23, 23, 23, 23, 23, 24],
  [25, 22, 9, 14, 5, 18, 2, 16, 7, 11, 0, 19, 22, 24],
  [26, 22, 17, 3, 10, 6, 21, 1, 15, 8, 12, 4, 22, 28],
  [27, 22, 1, 12, 4, 15, 9, 5, 18, 0, 13, 16, 22, 29],
  [28, 22, 13, 7, 19, 2, 11, 14, 3, 10, 20, 6, 22, 25],
  [29, 22, 5, 16, 0, 13, 8, 4, 12, 7, 15, 18, 22, 27],
  [30, 22, 11, 2, 20, 9, 17, 6, 1, 14, 3, 10, 22, 26],
  [31, 22, 4, 10, 15, 1, 3, 19, 8, 12, 16, 5, 22, 24],
  [30, 23, 23, 23, 23, 23, 23, 23, 23, 23, 23, 23, 23, 28],
  [28, 22, 18, 6, 11, 4, 10, 15, 2, 9, 5, 17, 22, 30],
  [24, 22, 16, 13, 7, 20, 0, 12, 19, 3, 14, 1, 22, 31],
  [24, 23, 23, 23, 23, 23, 23, 23, 23, 23, 23, 23, 22, 24],
  [24, 24, 25, 25, 26, 27, 28, 29, 30, 31, 24, 25, 26, 26]
]
    },
    {
  "name": "Level 4",
  "data": [
  [30, 24, 25, 25, 26, 27, 28, 29, 30, 31, 24, 25, 26, 27, 28, 24],
  [24, 23, 23, 23, 23, 23, 23, 23, 23, 23, 23, 23, 23, 23, 23, 24],
  [25, 22, 17, 3, 11, 6, 14, 1, 19, 8, 4, 12, 16, 5, 22, 24],
  [26, 22, 9, 15, 2, 13, 7, 20, 0, 10, 18, 5, 14, 3, 22, 28],
  [27, 22, 1, 10, 16, 4, 8, 12, 3, 17, 6, 11, 0, 19, 22, 29],
  [28, 22, 13, 7, 19, 5, 0, 15, 2, 14, 9, 18, 1, 16, 22, 25],
  [29, 22, 5, 18, 14, 1, 10, 6, 17, 11, 3, 20, 4, 8, 22, 27],
  [30, 22, 11, 2, 20, 9, 16, 3, 15, 7, 13, 4, 19, 12, 22, 26],
  [31, 22, 6, 17, 5, 12, 1, 18, 4, 10, 0, 14, 9, 13, 22, 24],
  [30, 23, 23, 23, 23, 23, 23, 23, 23, 23, 23, 23, 23, 23, 23, 28],
  [28, 22, 15, 4, 13, 7, 19, 2, 6, 18, 16, 0, 11, 9, 22, 30],
  [24, 22, 10, 1, 8, 14, 3, 17, 12, 5, 21, 7, 15, 16, 22, 31],
  [26, 22, 7, 11, 6, 18, 13, 4, 0, 16, 19, 2, 10, 17, 22, 30],
  [27, 22, 12, 16, 9, 3, 15, 10, 5, 1, 8, 13, 6, 14, 22, 29],
  [24, 23, 23, 23, 23, 23, 23, 23, 23, 23, 23, 23, 23, 23, 22, 24],
  [24, 24, 25, 25, 26, 27, 28, 29, 30, 31, 24, 25, 26, 27, 28, 24]
]
    },
    {
  "name": "Level 5",
  "data": [
  [30, 24, 25, 25, 26, 27, 28, 29, 30, 31, 24, 25, 26, 27, 28, 24, 24],
  [24, 23, 23, 23, 23, 23, 23, 23, 23, 23, 23, 23, 23, 23, 23, 23, 24],
  [25, 22, 12, 5, 18, 3, 11, 7, 14, 2, 16, 9, 20, 1, 15, 22, 24],
  [26, 22, 7, 16, 4, 13, 9, 15, 6, 0, 17, 10, 8, 19, 3, 22, 28],
  [27, 22, 1, 19, 10, 5, 17, 2, 11, 14, 3, 12, 6, 8, 20, 22, 29],
  [28, 22, 15, 4, 13, 0, 18, 7, 3, 16, 9, 14, 1, 11, 5, 22, 25],
  [29, 22, 8, 17, 6, 11, 1, 19, 5, 13, 20, 4, 10, 12, 7, 22, 27],
  [30, 22, 16, 3, 12, 14, 0, 8, 10, 6, 15, 18, 7, 2, 4, 22, 26],
  [31, 22, 4, 10, 15, 7, 2, 16, 11, 1, 13, 5, 9, 17, 6, 22, 24],
  [30, 23, 23, 23, 23, 23, 23, 23, 23, 23, 23, 23, 23, 23, 23, 23, 28],
  [28, 22, 18, 6, 13, 1, 4, 10, 9, 17, 5, 12, 16, 3, 19, 22, 30],
  [24, 22, 11, 0, 14, 7, 19, 3, 15, 8, 2, 16, 5, 13, 10, 22, 31],
  [26, 22, 9, 12, 5, 18, 6, 11, 17, 4, 10, 1, 7, 14, 0, 22, 30],
  [27, 22, 16, 3, 10, 2, 14, 5, 13, 7, 9, 15, 4, 8, 12, 22, 29],
  [25, 22, 4, 15, 19, 7, 11, 8, 1, 13, 6, 14, 3, 17, 10, 22, 28],
  [24, 23, 23, 23, 23, 23, 23, 23, 23, 23, 23, 23, 23, 23, 23, 22, 24],
  [24, 24, 25, 25, 26, 27, 28, 29, 30, 31, 24, 25, 26, 27, 28, 24, 26]
]

    },
    {
  "name": "Level 6",
  "data": [
  [30, 24, 25, 25, 26, 27, 28, 29, 30, 31, 24, 25, 26, 27, 28, 24, 24, 30],
  [24, 23, 23, 23, 23, 23, 23, 23, 23, 23, 23, 23, 23, 23, 23, 23, 23, 24],
  [25, 22, 10, 6, 17, 3, 14, 9, 1, 15, 4, 12, 18, 7, 2, 11, 22, 24],
  [26, 22, 15, 0, 13, 5, 11, 16, 8, 2, 19, 4, 20, 10, 6, 17, 22, 28],
  [27, 22, 2, 18, 7, 14, 1, 19, 10, 6, 12, 17, 5, 3, 9, 13, 22, 29],
  [28, 22, 11, 4, 16, 9, 15, 3, 20, 7, 1, 13, 17, 0, 14, 8, 22, 25],
  [29, 22, 7, 13, 0, 18, 4, 10, 5, 12, 16, 8, 11, 2, 19, 15, 22, 27],
  [30, 22, 14, 5, 11, 2, 17, 6, 13, 9, 21, 3, 7, 16, 18, 1, 22, 26],
  [31, 22, 9, 17, 3, 15, 0, 12, 4, 18, 6, 10, 14, 8, 5, 19, 22, 24],
  [30, 23, 23, 23, 23, 23, 23, 23, 23, 8, 23, 23, 23, 23, 23, 23, 23, 28],
  [28, 22, 18, 6, 12, 1, 4, 15, 17, 7, 13, 9, 0, 11, 16, 3, 22, 30],
  [24, 22, 16, 13, 5, 10, 8, 2, 19, 4, 15, 1, 7, 14, 9, 12, 22, 31],
  [26, 22, 3, 14, 7, 16, 11, 5, 1, 10, 8, 18, 2, 17, 13, 6, 22, 30],
  [27, 22, 17, 0, 15, 4, 12, 9, 6, 3, 14, 11, 19, 5, 10, 7, 22, 29],
  [25, 22, 8, 16, 19, 7, 13, 1, 2, 15, 5, 6, 17, 12, 4, 14, 22, 28],
  [29, 22, 4, 10, 18, 3, 14, 11, 9, 0, 13, 16, 8, 2, 5, 7, 22, 27],
  [24, 23, 23, 23, 23, 23, 23, 23, 23, 23, 23, 23, 23, 23, 23, 23, 22, 24],
  [24, 24, 25, 25, 26, 27, 28, 29, 30, 31, 24, 25, 26, 27, 28, 24, 24, 30]
]
    },
    {
  "name": "Level 7",
  "data": [
  [30, 24, 25, 25, 26, 27, 28, 29, 30, 31, 24, 25, 26, 27, 28, 24, 24, 30, 31, 28],
  [24, 23, 23, 23, 23, 23, 23, 23, 23, 23, 23, 23, 23, 23, 23, 23, 23, 23, 23, 24],
  [25, 22, 10, 16, 18, 13, 17, 6, 14, 22, 11, 20, 8, 19, 6, 12, 15, 9, 22, 24],
  [26, 22, 19, 7, 14, 11, 21, 10, 0, 22, 13, 8, 17, 15, 16, 1, 18, 20, 22, 28],
  [27, 22, 1, 15, 4, 5, 6, 19, 17, 22, 7, 14, 16, 0, 20, 21, 10, 8, 22, 29],
  [28, 22, 16, 17, 2, 3, 10, 6, 18, 22, 21, 1, 19, 11, 9, 6, 12, 15, 22, 25],
  [29, 22, 7, 0, 6, 17, 9, 11, 15, 22, 10, 6, 6, 8, 14, 12, 18, 21, 22, 27],
  [30, 22, 18, 6, 21, 14, 13, 7, 19, 22, 8, 17, 15, 16, 6, 9, 10, 6, 22, 26],
  [31, 22, 6, 18, 10, 15, 0, 12, 9, 22, 14, 13, 20, 6, 17, 19, 8, 16, 22, 24],
  [30, 23, 23, 23, 23, 23, 23, 23, 23, 6, 23, 23, 23, 23, 23, 23, 23, 23, 23, 28],
  [28, 22, 14, 9, 16, 12, 7, 20, 11, 22, 8, 11, 6, 17, 21, 15, 13, 18, 22, 30],
  [24, 22, 12, 13, 17, 0, 18, 1, 15, 22, 6, 10, 11, 14, 19, 7, 20, 6, 22, 31],
  [26, 22, 11, 14, 9, 19, 6, 16, 10, 22, 17, 15, 13, 18, 12, 20, 7, 1, 22, 30],
  [27, 22, 8, 12, 15, 7, 19, 21, 11, 22, 9, 18, 0, 10, 6, 6, 19, 13, 22, 29],
  [25, 22, 13, 1, 16, 18, 14, 9, 7, 22, 15, 21, 17, 12, 0, 4, 5, 19, 22, 28],
  [29, 22, 17, 10, 11, 6, 1, 0, 13, 22, 12, 7, 21, 6, 8, 2, 3, 14, 22, 27],
  [28, 22, 20, 13, 8, 12, 15, 18, 14, 22, 16, 9, 10, 17, 7, 1, 0, 11, 22, 26],
  [24, 22, 16, 21, 14, 10, 17, 13, 18, 22, 19, 6, 1, 7, 15, 11, 12, 20, 22, 25],
  [24, 23, 23, 23, 23, 23, 23, 23, 23, 23, 23, 23, 23, 23, 23, 23, 23, 23, 22, 24],
  [24, 24, 25, 25, 26, 27, 28, 29, 30, 31, 24, 25, 26, 27, 28, 24, 24, 30, 31, 26]
]
    },
    {
  "name": "Level 8",
  "data": [
  [30, 24, 25, 25, 26, 27, 28, 29, 30, 31, 24, 25, 26, 27, 28, 24, 24, 30, 31, 28],
  [24, 23, 23, 23, 23, 23, 23, 23, 23, 23, 23, 23, 23, 23, 23, 23, 23, 23, 23, 24],
  [25, 22, 9, 14, 1, 19, 6, 17, 12, 5, 10, 8, 16, 3, 20, 11, 4, 0, 22, 24],
  [26, 22, 18, 0, 15, 7, 13, 4, 21, 16, 2, 19, 11, 6, 17, 14, 9, 1, 22, 28],
  [27, 22, 5, 10, 17, 3, 8, 11, 1, 14, 15, 7, 0, 18, 4, 12, 6, 20, 22, 29],
  [28, 22, 11, 16, 6, 12, 19, 2, 15, 9, 3, 21, 7, 10, 13, 5, 8, 17, 22, 25],
  [29, 22, 2, 8, 20, 14, 5, 16, 3, 7, 18, 12, 10, 1, 9, 15, 6, 13, 22, 27],
  [30, 22, 15, 6, 13, 17, 10, 1, 21, 4, 11, 9, 2, 20, 18, 7, 3, 16, 22, 26],
  [31, 22, 7, 19, 4, 8, 14, 5, 10, 18, 6, 15, 1, 12, 17, 0, 13, 21, 22, 24],
  [30, 23, 23, 23, 23, 23, 23, 23, 23, 1, 23, 23, 23, 23, 23, 23, 23, 23, 23, 28],
  [28, 22, 16, 11, 3, 6, 20, 18, 7, 13, 9, 0, 14, 5, 10, 2, 17, 19, 22, 30],
  [24, 22, 8, 5, 10, 15, 4, 19, 16, 2, 7, 11, 13, 1, 6, 18, 3, 14, 22, 31],
  [26, 22, 14, 1, 13, 18, 17, 6, 0, 10, 12, 3, 15, 8, 21, 4, 9, 5, 22, 30],
  [27, 22, 10, 7, 19, 4, 15, 8, 12, 1, 16, 14, 6, 11, 0, 13, 5, 2, 22, 29],
  [25, 22, 3, 17, 5, 11, 9, 20, 13, 6, 19, 18, 4, 15, 7, 10, 1, 16, 22, 28],
  [29, 22, 12, 2, 16, 0, 18, 14, 7, 10, 5, 13, 17, 9, 3, 21, 11, 8, 22, 27],
  [28, 22, 4, 9, 6, 15, 1, 17, 19, 3, 20, 4, 12, 16, 14, 8, 0, 5, 22, 26],
  [24, 22, 13, 21, 7, 2, 11, 0, 8, 12, 17, 6, 15, 10, 18, 9, 1, 3, 22, 25],
  [24, 23, 23, 23, 23, 23, 23, 23, 23, 23, 23, 23, 23, 23, 23, 23, 23, 23, 22, 24],
  [24, 24, 25, 25, 26, 27, 28, 29, 30, 31, 24, 25, 26, 27, 28, 24, 24, 30, 31, 26]
]

    },
    {
  "name": "Level 9",
  "data": [
  [30, 24, 25, 25, 26, 27, 28, 29, 30, 31, 24, 25, 26, 27, 28, 24, 24, 30, 31, 28],
  [24, 23, 23, 23, 23, 23, 23, 23, 23, 23, 23, 23, 23, 23, 23, 23, 23, 23, 23, 24],
  [25, 22, 0, 16, 7, 11, 5, 18, 4, 15, 9, 2, 13, 10, 21, 3, 19, 8, 22, 24],
  [26, 22, 12, 3, 10, 9, 17, 1, 15, 6, 18, 4, 20, 0, 11, 5, 14, 16, 22, 28],
  [27, 22, 8, 14, 21, 0, 6, 12, 19, 7, 13, 16, 9, 5, 2, 10, 3, 17, 22, 29],
  [28, 22, 17, 5, 13, 15, 2, 20, 3, 11, 4, 8, 18, 14, 6, 19, 1, 10, 22, 25],
  [29, 22, 4, 10, 6, 18, 16, 7, 1, 12, 9, 21, 5, 3, 17, 0, 15, 11, 22, 27],
  [30, 22, 19, 2, 15, 4, 11, 13, 8, 0, 17, 10, 7, 18, 9, 6, 12, 20, 22, 26],
  [31, 22, 1, 7, 14, 17, 19, 6, 20, 16, 5, 3, 11, 8, 13, 15, 4, 9, 22, 24],
  [30, 23, 23, 23, 23, 23, 23, 23, 23, 6, 23, 23, 23, 23, 23, 23, 23, 23, 23, 28],
  [28, 22, 13, 8, 0, 5, 21, 4, 10, 18, 16, 7, 3, 19, 12, 6, 14, 11, 22, 30],
  [24, 22, 11, 19, 1, 14, 15, 10, 7, 3, 8, 12, 17, 6, 4, 13, 9, 20, 22, 31],
  [26, 22, 16, 12, 4, 6, 8, 17, 11, 2, 15, 19, 0, 10, 5, 7, 18, 3, 22, 30],
  [27, 22, 5, 7, 18, 13, 0, 9, 14, 17, 6, 1, 12, 16, 10, 11, 4, 21, 22, 29],
  [25, 22, 9, 4, 11, 16, 10, 15, 2, 8, 19, 7, 20, 3, 18, 13, 5, 1, 22, 28],
  [29, 22, 6, 13, 3, 20, 12, 5, 17, 14, 10, 9, 4, 11, 7, 16, 2, 18, 22, 27],
  [28, 22, 14, 15, 8, 1, 19, 11, 6, 0, 12, 17, 13, 2, 5, 4, 9, 21, 22, 26],
  [24, 22, 7, 10, 2, 16, 3, 14, 5, 13, 18, 6, 20, 1, 9, 17, 15, 12, 22, 25],
  [24, 23, 23, 23, 23, 23, 23, 23, 23, 23, 23, 23, 23, 23, 23, 23, 23, 23, 22, 24],
  [24, 24, 25, 25, 26, 27, 28, 29, 30, 31, 24, 25, 26, 27, 28, 24, 24, 30, 31, 26]
]


    },
    {
  "name": "Level 10",
  "data": [
  [30, 24, 25, 25, 26, 27, 28, 29, 30, 31, 24, 25, 26, 27, 28, 24, 24, 30, 31, 28],
  [24, 23, 23, 23, 23, 23, 23, 23, 23, 23, 23, 23, 23, 23, 23, 23, 23, 23, 23, 24],
  [25, 22, 13, 8, 19, 3, 10, 7, 1, 16, 5, 14, 9, 12, 20, 4, 17, 11, 22, 24],
  [26, 22, 2, 15, 6, 17, 4, 18, 9, 0, 11, 21, 8, 13, 3, 10, 5, 19, 22, 28],
  [27, 22, 14, 0, 11, 5, 12, 1, 16, 7, 19, 6, 2, 15, 9, 17, 8, 13, 22, 29],
  [28, 22, 9, 18, 3, 10, 15, 2, 5, 13, 17, 4, 16, 1, 11, 7, 20, 6, 22, 25],
  [29, 22, 17, 4, 13, 8, 6, 16, 11, 9, 0, 19, 7, 5, 14, 2, 12, 15, 22, 27],
  [30, 22, 5, 12, 20, 14, 1, 3, 18, 6, 15, 10, 13, 4, 8, 21, 7, 17, 22, 26],
  [31, 22, 16, 6, 9, 11, 17, 5, 14, 2, 18, 7, 0, 19, 13, 12, 10, 3, 22, 24],
  [30, 23, 23, 23, 23, 23, 23, 23, 23, 2, 23, 23, 23, 23, 23, 23, 23, 23, 23, 28],
  [28, 22, 18, 7, 10, 15, 9, 4, 3, 17, 6, 1, 14, 16, 12, 5, 13, 0, 22, 30],
  [24, 22, 11, 1, 16, 6, 13, 19, 8, 14, 5, 9, 10, 3, 7, 18, 21, 2, 22, 31],
  [26, 22, 4, 13, 0, 9, 17, 8, 15, 5, 2, 11, 19, 6, 10, 14, 3, 16, 22, 30],
  [27, 22, 15, 3, 12, 2, 5, 10, 14, 1, 7, 16, 4, 18, 9, 13, 17, 20, 22, 29],
  [25, 22, 6, 17, 19, 4, 7, 11, 13, 15, 3, 12, 5, 8, 16, 21, 1, 10, 22, 28],
  [29, 22, 10, 5, 14, 1, 2, 18, 17, 8, 6, 13, 20, 9, 15, 0, 4, 11, 22, 27],
  [28, 22, 19, 9, 7, 16, 3, 12, 6, 10, 14, 5, 1, 17, 2, 11, 8, 13, 22, 26],
  [24, 22, 8, 20, 15, 13, 4, 0, 11, 7, 16, 9, 18, 5, 12, 14, 6, 1, 22, 25],
  [24, 23, 23, 23, 23, 23, 23, 23, 23, 23, 23, 23, 23, 23, 23, 23, 23, 23, 22, 24],
  [24, 24, 25, 25, 26, 27, 28, 29, 30, 31, 24, 25, 26, 27, 28, 24, 24, 30, 31, 26]
]
    },
    {
  "name": "Level 11",
  "data": [
  [30, 24, 25, 25, 26, 27, 28, 29, 30, 31, 24, 25, 26, 27, 28, 24, 24, 30, 31, 28, 26],
  [24, 23, 23, 23, 23, 23, 23, 23, 23, 23, 23, 23, 23, 23, 23, 23, 23, 23, 23, 24, 23],
  [25, 22, 10, 6, 17, 3, 14, 9, 1, 15, 4, 12, 18, 7, 2, 11, 13, 5, 16, 22, 24],
  [26, 22, 15, 0, 13, 5, 11, 16, 8, 2, 19, 4, 20, 10, 6, 17, 9, 18, 3, 22, 28],
  [27, 22, 2, 18, 7, 14, 1, 19, 10, 6, 12, 17, 5, 3, 9, 13, 0, 20, 4, 22, 29],
  [28, 22, 11, 4, 16, 9, 15, 3, 20, 7, 1, 13, 17, 0, 14, 8, 6, 12, 18, 22, 25],
  [29, 22, 7, 13, 0, 18, 4, 10, 5, 12, 16, 8, 11, 2, 19, 15, 3, 9, 7, 22, 27],
  [30, 22, 14, 5, 11, 2, 17, 6, 13, 9, 21, 3, 7, 16, 18, 1, 4, 10, 15, 22, 26],
  [31, 22, 9, 17, 3, 15, 0, 12, 4, 18, 6, 10, 14, 8, 5, 19, 2, 11, 13, 22, 24],
  [30, 23, 23, 23, 23, 23, 23, 23, 23, 17, 23, 23, 23, 23, 23, 23, 23, 23, 23, 23, 28],
  [28, 22, 18, 6, 12, 1, 4, 15, 17, 7, 13, 9, 0, 11, 16, 3, 10, 14, 5, 22, 30],
  [24, 22, 16, 13, 5, 10, 8, 2, 19, 4, 15, 1, 7, 14, 9, 12, 18, 6, 20, 22, 31],
  [26, 22, 3, 14, 7, 16, 11, 5, 1, 10, 8, 18, 2, 17, 13, 6, 4, 19, 0, 22, 30],
  [27, 22, 17, 0, 15, 4, 12, 9, 6, 3, 14, 11, 19, 5, 10, 7, 16, 13, 8, 22, 29],
  [25, 22, 8, 16, 19, 7, 13, 1, 2, 15, 5, 6, 17, 12, 4, 14, 9, 11, 3, 22, 28],
  [29, 22, 4, 10, 18, 3, 14, 11, 9, 0, 13, 16, 8, 2, 5, 7, 15, 20, 12, 22, 27],
  [28, 22, 19, 5, 7, 12, 3, 17, 10, 6, 15, 18, 4, 1, 9, 14, 11, 13, 0, 22, 26],
  [24, 22, 0, 16, 11, 8, 15, 4, 13, 7, 19, 2, 10, 5, 17, 12, 14, 3, 6, 22, 25],
  [24, 22, 9, 1, 5, 10, 16, 13, 7, 14, 2, 4, 18, 8, 11, 15, 0, 17, 12, 22, 24],
  [24, 23, 23, 23, 23, 23, 23, 23, 23, 23, 23, 23, 23, 23, 23, 23, 23, 23, 23, 22, 24],
  [24, 24, 25, 25, 26, 27, 28, 29, 30, 31, 24, 25, 26, 27, 28, 24, 24, 30, 31, 26, 26]
]
    }
    
]